Guillaume du Bois' soulful wine|Uncle toms exquisite blanc
Chateau d'Adam Chevalier Pinot Blanc Reserve|Chevalier adam pinot blanc reserve
Fiorano wine|Prince john merlot
Count var Ochmann Shiraz|Count var ochmann shiraz
Chateau de Conrad Cabernet|Chateau de konrad cabernet
Geralt of Rivia|Geralt de rivia
White Wolf|White Wolf
Butcher of Blaviken|Butcher of Blaviken
Gutted pheasant|Pheasant gutted
Tarte tatin|Tarte tatin
Ratatouille|Ratatouille
Baguette with camembert|Baguette camembert
Honey croissant|Crossaint honey
Herb toast|Herb toasts
Brioche|Brioche
Flamiche|Flamiche
Camembert|Camembert
Chocolate souffle|hocolate souffle
Chicken liver pate|Pate chicken livers
Duck confit|Confit de canard
Baguette with fish pate|Baguette fish paste
Fish tart|Fish tarte
Boeuf bourguignon|Boeuf bourguignon
Pork rillettes|Rillettes porc
Onion soup|Onion soup
Roasted ham|Ham roasted
Tomato|Tomato
Cookies|Cookies
Gingerbread|Ginger Bread
Goat's milk|Goats milk
Magic mushrooms|Magic Mushrooms
Poisoned apple|Poison Apple
Mushroom|Mushroom
Mutton stew|Mutton curry
Mutton leg|Mutton leg
Olive|Olive
Onion|Onion
Pear|Pear
Black pepper|Pepper
Plum|Plum
Beauclair white|Beauclair White
Pork|Pork
Dijkstra dry|Dijkstra Dry
Grilled pork|Grilled pork
Erveluce|Erveluce
Potatoes|Potatoes
Est Est|Est Est
Baked potato|Baked potato
Potato wedges|Chips
Golden egg|q704_ft_golden_egg
Cake|mq7023_cake
Raspberry juice|Raspberry juice
Metinna rose|Mettina Rose
Bread|Bread
Water|Bottled water
"Vis la Crac" Wine|poi_gor_a_10_vine_edible
Homemade pepper vodka|Local pepper vodka
Potion from Tir ná Œia|Tirnalia potion
Strawberries|Strawberries
Magic acorn|q111_imlerith_acorn
Redanian lager|Redanian Lager
Rivian kriek|Rivian Kriek
Toffee|Toffee
Viziman Champion|Viziman Champion
Werewolf meat|sq201_werewolf_meat
Baked apple|Baked apple
Dumpling|Dumpling
Apple|Apple
Kaedweni stout|Kaedwenian Stout
Raspberries|Raspberries
Banana|Banana
Vinegar|Vinegar
Bell pepper|Bell pepper
Butter|Butter Bandalura
Rotting flesh|sq201_rotten_meat
Blueberries|Blueberries
Burned bread|Burned bread
Apple juice|Apple juice
Sweet bun|Bun
Burned sweet bun|Burned bun
Candy|Candy
Jar of honey|Jar of Honey
Roasted chicken leg|Free roasted chicken leg
Cheese|Cheese
Chicken|Chicken
Chicken leg|Chicken leg
Roasted chicken leg|Roasted chicken leg
Roasted chicken|Roasted chicken
Chicken sandwich|Chicken sandwich
Grilled chicken sandwich|Grilled chicken sandwich
Horn of Plenty|Cornucopia
Cucumber|Cucumber
Magic food|Magic food
Dried fruit|Dried fruit
Victor Monnart's cognac|mq7021_cognac
Dried fruit and nuts|Dried fruit and nuts
Fish|Fish
Dried fish|Fried fish
Gutted fish|Gutted fish
Fondue|Fondue
Grapes|Grapes
Ham sandwich|Ham sandwich
Exquisite honey|Very good honey
Honeycomb|Honeycomb
Fried meat|Fried meat
Raw meat|Raw meat
Egg|Egg
Cow's milk|Cows milk
Sansretour Chardonnay|Bourgogne chardonnay
Chateau Mont Valjean|Chateau mont valjean
Crayfish chowder|q701_crayfish_soup
Hare pate|q701_pate
Sansretour Pinot Noir|Bourgogne pinot noir
Saint Mathieu Rouge|Saint mathieu rouge
Duke Nicolas Chardonnay|Duke nicolas chardonnay
Honeycomb|mq2039_Honeycomb